................................................
................................................
................................................
................................................
................................................
.............................==.................
................................................
....==######################...#################
==....######################...#################
................................................
...==...........................................
.....................==.........................
==..............................................
...........................................==...
####################...###################......
####################...###################....==
................................................
...........................................==...
................................................
..............................................==
................................................
################################################
################################################
################################################