#................................................
#................................................
#................................................
#................................................
#................................................
#................................................
#................................................
#............................###############...##
#..........................#################..==#
#........................######...........#.....#
#......................########...........#==...#
#....................##########.................#
#..................############...............==#
#................##############.................#
###########################################==...#
######################...##################.....#
#.........................................#...==#
#.........................................#.....#
#.........................................#==...#
#...............................................#
#.............................................==#
.......##########################################
.....############################################
...##############################################
.################################################
#################################################
#################################################
#################################################