................................................
................................................
................................................
................................................
................................................
.########################.......................
.########################.......................
..........................==....................
................................................
............................==..................
................................................
..............................==####............
...........................==...####..==........
....######################......................
..==######################..............==......
................................................
==........................................==....
................................................
..==........................................####
............................................####
################################################
################################################