#...............................................#
#...............................................#
#...............................................#
#...............................................#
#...............................................#
#...............................................#
#...............................................#
####################################...####....##
####################################...####==..##
#.........................................#.....#
#.............................................==#
#...............................................#
#..........................................==...#
####...####################################.....#
####...####################################...==#
#.........................................#.....#
#.........................................#==...#
#.........................................#.....#
#.........................................#...==#
#.........................................#.....#
#..==.....................................#==...#
#...............................................#
#.....==......................................==#
#...............................................#
#################################################
#################################################