................................................
................................................
................................................
................................................
................................................
................................................
................................................
................................................
................................................
................................................
................................................
######.===..====..====..====..====..==.==.######
######....................................######
###.####................................########
##########............................##########
############........................############
############........................############
##############....................##############
##############....................##############
#################..............#################
#################..............#################
################################################
################################################
################################################