................................................
................................................
................................................
................................................
................................................
................................................
................................................
................................................
................................................
................................................
##############.==...........==.==.##############
##############...==......==.......##############
##############.......===..........##############
##############.....==.............##############
##############..==................##############
##############....................##############
...................==...........................
................................................
................==..............................
..............==................................
................................................
################################################
################################################
################################################